10
x x x x x x x x x x
x p x x p x x p g x
x p p p p x p p x x
x x x p p x p p p x
x p p p x x x x p x
x x x p p p p p p x
x p p p x x x x x x
x x x p x x x p p x
x x x p p p p p x x
x x x x x x x x x x